#####################################################
#,,,,,,,,,,,,,,,,,,,,,,,                           @#
#!,,,,,,,############################################
#,,,,,,,,,,,,,,,    ^      ^   ########////////#///?#
#### ##############################////////////#/####
#    #^     ^   #       ^      #///////////////#////#
# ###### ## #####    ^        ^#////////////$//####/#
#        #         *            ////////////////////#
#####################################################